10x10 *   o 1 2
**********
*1********
**    * **
**  * * **
** * *  **
**     ***
**  * * **
***   * **
********2*
**********
